######
#A   #
# ## #
#    #
# ##B#
######