##########
#A#     ##
# # ###  #
# # # ## #
#   #    #
### #### #
#     #  #
# ### # ##
#   #   B#
##########