########
#A #   #
#  # # #
##   # #
# #### #
#      #
# ####B#
########